        1111111111111111111111111
        1000000000110000000000001
        1011000001110000000000001
        1001000000000000000000001
111111111011000001110000000000001
100000000011000001110111110111111
1111011111111101110000001000001
1111011111111101110101001000001
1100000011010101110000001010001
1000000000000000110000001000001
10000000000000001101010010N0001
1000000111010101111101111000111
11111111 1110101 111111110001
11111111 1111111 111111111111