        1111111111111111111111111
        1000000000110000000000001
        1011000001110000000002001
        1001000000000000000000001
111111111011000001110000000000001
100000000211000001110111110111111
1111011111111101110000001000001
1111011111111101110101000000001
11000000110101011100000000000011
100000000000000011000000000N001
1000000020000000110100000000001
1000000111010101111101111000111
11111111 1110101 11111111002111
11111111 1111111 11111111111111