R 1000, 800
F 50, 215, 20
C 134, 134, 210

S ./images/pillar.xpm
SO ./images/wall_1.xpm
NO ./images/colorstone_1.xpm
WE ./images/brick.xpm
EA ./images/bluestone.xpm

        1111111111111111111111111111
        100000000011000000000000000111
        1011000001110000000000001111
        100100000000000000W000011
111111111011000001110000000000001
100000000011000001110111110000111
1111011111111101110000000020001
11110111111110111010100000000111
11000000110101011100000000000111
10000000000000001100000200000011
10000000000002011012002000000011111111
11111111111101011111111110001111110101
11111111 1111111 111111111111111111111