R 800 600
F 50, 215, 20
C 150, 180, 205

S ./images/pillar.xpm
SO ./images/wall_1.xpm
NO ./images/colorstone_1.xpm
WE ./images/brick.xpm
EA ./images/bluestone.xpm

        1111111111111111111111111111
        1000000000110000000000000001
        1011000001110000000000001111
        1001000000000000000000001
111111111011000001110000000000001
100000000011000001110111110000111
1111011111111101110000000020001
1111011111111101110101000000001
11000000110101011100000000000011
10000000000000001100000200N00011
1000000000000201101200200000001
1000000111010101111101111000111
11111111 1110101 11111111000111
11111111 1111111 11111111111111