        1111111111111111111111111
        1000000000110000000000001
        1011000001110000000000001
        1001000000000000000000001
111111111011000001110000000000001
100000000011000001110111110000111
1111011111111101110000001020001
1111011111111101110101000000001
11000000110101011100000000000011
10000000000000001100000000N0001
1000000000000000110100000000001
1000000111010101111101111000111
11111111 1110101 11111111000111
11111111 1111111 11111111111111