R 800, 600
F 200, 215, 20
C 134, 4, 210

S ./images/pillar.xpm
SO ./images/wall_1.xpm
NO ./images/colorstone_1.xpm
WE ./images/brick.xpm
EA ./images/bluestone.xpm

        11111111111111111111111111111111
        10000000000110000000000001111121
        10110000011100000000000011111011
        1111111111111111111111011111011111
111     110010000000000000000000011111111111
1011111111011000001110000000W000011101111101
100000000011000001110111110000100111111111111
1111011111111101110000000000001111111
1111011111111011101010000001111000001111
1100000011010101110000000000011111111021
 100000000000000110000020000011112122111
110000000000020110120020000001111111121
101111111111010111111111100011111101111
1111111111111111111111111111111111111